8888888888
8888888888
8888888888
8888888888
8888888888
8888888888
8888888888
8888888888
8888888888
8888888888
-
1010111111
0111010000
1000501100
1001000101
0000011100
1011010100
0100101011
0111103111
0010101011
1001101310
0001200001
-
0112111100
0010120110
1110020001
1110200100
0100101000
1001100110
0010001100
0011100000
1021011100
0100001100
-
0100001010
0000010100
0000100011
0101011011
3101101010
1001011111
0110001001
3001101001
0301103001
0101010111
-
1100111011
0001101000
1100001001
1100000011
0020001140
1100110101
0000101001
1111000000
1020000101
0001011010
-
1000111100
1000011001
1111101010
0101004101
1101211111
1000001001
0111110000
0010100000
0101000001
1111101003
-
1000010110
0100120101
1111100011
1101010011
1001001010
2001001001
0101011000
1001011110
0001310110
0100100001
-
0011100110
0010011100
0101100110
1100000103
1101111100
1100001000
1110000010
1100001103
1000101011
0000000002
-
0100000100
1100100001
1103101111
0111010101
0000220010
0101110001
1001001001
1010000000
0010110001
1000001001
-
0000000200
0001001001
0010100010
1000011010
1001010110
0010100110
1210000011
0101001010
1001010011
0000111111
-
0000000011
1001010110
0000100010
1000010100
0011000010
1011110311
1000101000
1011000000
0000011110
0100111100
-
0000101100
0101101010
0311100010
0000010001
0001013110
0130010010
0110001000
1101010101
1000130000
1001000000
-
0100001010
1100100001
0000100300
1101011011
0011010004
1000110011
0100010111
0001103000
1010101030
0110001011
-
1000010111
1001100010
0301000000
1000010000
1101101010
1101101001
1100101011
1101000100
1110010100
0101000000
-
0011111010
1110011000
1113000010
0011201101
0000006011
0110000110
3101001001
1010011100
1101100000
1000330100
-
0001000010
0101001100
0111110000
1000101000
0001101101
1001110010
0111110011
0100001001
0000000021
0100011010
-
0101011021
0101011001
0110001010
2111110111
0100111010
0001000000
0010001001
1001000001
0000000001
0000001100
-
0010002001
0100110101
0000000110
0100000011
0000000300
0001110111
0111110000
0010001000
1011111101
0101011101
-
0100040021
1001110100
0110000000
0100111010
0100110011
1110003110
1031001010
2100000000
0101101106
0111000110
-
1100110102
1110000100
0110010000
1102213000
0000100010
1011100101
0001000011
0001101101
0010110010
0000100000
-
0000100101
1000000001
0000110111
0000010011
0101100110
1001111001
1011101100
0001001110
0010010011
0100131000
-
0000000000
0111011101
0010100000
1000000001
0110010001
0003100000
0000001000
0100001101
1110001011
0121134221
-
7777777777
7777777777
7777777777
7777777777
7777777777
7777777777
7777777777
7777777777
7777777777
7777777777
