8888888888
8888888888
8888888888
8888888888
8888888888
8888888888
8888888888
8888888888
8888888888
8888888888
-
0000000101
1101120100
0000211101
1411111000
0111110110
0101000101
0000101011
1010100010
0110010001
1101010000
0100100100
-
0100000010
0000001011
1010001011
1211000000
1100001001
0130000101
0110001000
0011001101
0101011001
1101000211
-
0000011110
0101100001
1000001100
0000301110
1100020110
1010001110
1110010000
2110010010
0000011001
1100101110
-
1011001000
0101011010
0101010110
1000000101
1010000031
0001010000
1011000010
0100000111
1010000011
1110010001
-
1010001010
0001100100
1000100000
1110211011
0001000001
1111100000
0011100001
1011000110
1000200210
0101011101
-
1100110111
1110014000
0000100001
0000001110
1011100001
1000101110
1100011201
0000101010
0000000010
1010110110
-
0110000010
0012100110
0410100100
1000000010
0000100100
0111011110
0010100010
0100100010
1000000100
0001110101
-
0101011111
1010000000
0111101001
0000020000
1001000101
0010100010
0101011006
0111001011
1000101021
0000001001
-
0100010001
1010101010
0100110110
0101100011
0101101100
0110010000
3100000110
0000111011
0000001030
0000101110
-
0001001100
0001013011
0010000111
1111000001
1111001010
1111031000
1001110100
0011111000
1000001001
0010000001
-
0000011001
0110000100
0010111000
0011100010
0010010000
1101010011
0010011000
1000110000
0011001001
0010000000
-
0000110010
0130003002
1100100110
0110101001
0100010111
1111100000
1000000310
1101000010
0001010110
0011600001
-
0110012101
0010001100
0001000010
0100100300
0010002100
0110010000
0000010001
1101011001
0101010100
0100003010
-
0002000100
0111110101
0010010001
0000001001
0110000000
0010001001
0010010200
0110111100
1100000000
0100014111
-
0010101010
1110011011
0201013110
0100001001
0000010002
1011000000
1010100001
1000011001
0101011102
0000020000
-
0010000000
1002000010
1010111010
1001001010
1010001101
1011011010
0101110100
0000010111
1100000011
0000100000
-
0111000300
0110011110
1210010010
1012300010
1000010001
1000010011
0010111000
0010000110
0101101001
1001011000
-
0210000110
1010100010
0000101101
1101000000
1010001001
0100100110
1000010000
1040100101
0011010000
2010001101
-
0010011010
0000101001
0001010010
1010000000
1001110012
1000001001
0001001010
1010000001
1011000001
0000010300
-
0000001301
1010001001
1001100111
0001011000
1000001110
0101010100
1000011001
0010101100
0001000000
0000010110
-
1101101000
1111110420
1000000010
1010010011
3020000000
0011100200
1101000001
1011011000
0000010000
0121134221
-
7777777777
7777777777
7777777777
7777777777
7777777777
7777777777
7777777777
7777777777
7777777777
7777777777
